Imperf	IPFV
BF	BFOC
Perf	PFV
Reciprocal	RECP
AF	AGFOC
DF	DFOC
INFINITIVE	NFIN
Causative	CAUS
Intensive	PURP
A1F	ACFOC
A2F	ADFOC
Distributive	DST
Associative	COM
IF	IFOC
LF	LFOC
Cont	INTEN
Accidental	ACCID
Involuntary	UNINT
OF	PFOC
Recperf	RCT;PFV
RF	RFOC
Indicative	IND
RfF	RFOC
OF/DF	PFOC/DFOC
Aptative	ABLE
Inf	NFIN
PL	PL
